XAL = "countries/Alabama.txt"
BMH = "countries/Birmingham.txt"
MGM = "countries/Montgomery.txt"
TCL = "countries/Tuscaloosa.txt"
MSH = "countries/Muscle Shoals.txt"
HTV = "countries/Huntsville.txt"
SCT = "countries/Scottsboro.txt"
GSD = "countries/Gadsden.txt"
MOB = "countries/Mobile.txt"
DOT = "countries/Dothan.txt"
XCT = "countries/Connecticut.txt"
SMF = "countries/Stamford.txt"
TRR = "countries/Torrington.txt"
NGT = "countries/Nagatuck.txt"
BPT = "countries/Bridgeport.txt"
HFD = "countries/Hartford.txt"
KIL = "countries/Killingly.txt"
NWC = "countries/Norwich.txt"
MDT = "countries/Middletown.txt"
NHV = "countries/New Haven.txt"
XDE = "countries/Delaware.txt"
DOV = "countries/Dover.txt"
WMT = "countries/Wilmington.txt"
GGT = "countries/Georgetown.txt"
XFL = "countries/Florida.txt"
RLD = "countries/Orlando.txt"
PBY = "countries/Palm Bay.txt"
TVG = "countries/The Villages.txt"
DTA = "countries/Deltona.txt"
WCL = "countries/Wauchula.txt"
LLD = "countries/Lakeland.txt"
TMP = "countries/Tampa.txt"
CTR = "countries/Citrus.txt"
OCL = "countries/Ocala.txt"
JSV = "countries/Jacksonville.txt"
PLK = "countries/Palatka.txt"
LKC = "countries/Lake.txt"
ALU = "countries/Alachua.txt"
PNC = "countries/Pensacola.txt"
CSV = "countries/Crestview.txt"
PNM = "countries/Panama City.txt"
FGC = "countries/Forgotten Coast.txt"
THS = "countries/Tallahassee.txt"
LCI = "countries/Lucie.txt"
OKB = "countries/Okeechobee.txt"
SBS = "countries/Sebastian.txt"
MII = "countries/Miami.txt"
KEY = "countries/Key West.txt"
NPS = "countries/Naples.txt"
CCL = "countries/Cape Coral.txt"
PUG = "countries/Punta Gorda.txt"
ACD = "countries/Arcadia.txt"
SRS = "countries/Sarasota.txt"
CWS = "countries/Clewiston.txt"
SBG = "countries/Sebring.txt"
XGA = "countries/Georgia.txt"
CDT = "countries/Cedartown.txt"
RME = "countries/Rome.txt"
ATN = "countries/Athens.txt"
THO = "countries/Thomaston.txt"
LGG = "countries/LaGrange.txt"
GSV = "countries/Gainesville.txt"
CNL = "countries/Cornelia.txt"
TCA = "countries/Toccoa.txt"
ATL = "countries/Atlanta.txt"
WRR = "countries/Warner Robins.txt"
MGV = "countries/Milledgeville.txt"
AGA = "countries/Augusta.txt"
CMB = "countries/Columburn.txt"
MCN = "countries/Macon.txt"
SMR = "countries/Summerville.txt"
CLH = "countries/Calhoun.txt"
DTN = "countries/Dalton.txt"
JSP = "countries/Jesup.txt"
BCK = "countries/Brunswick.txt"
CMD = "countries/Camden.txt"
HSV = "countries/Hinesville.txt"
SBR = "countries/Statesboro.txt"
SVH = "countries/Savannah.txt"
AMC = "countries/Americus.txt"
GAB = "countries/Peach Albany.txt"
VDT = "countries/Valdosta.txt"
TFT = "countries/Tift.txt"
FZG = "countries/Fitzgerald.txt"
WCS = "countries/Waycross.txt"
DBN = "countries/Dublin.txt"
ERL = "countries/Early.txt"
BBG = "countries/Bainbridge.txt"
NAU = "countries/North Atlantic Union.txt"
LGI = "countries/Long Island.txt"
NIA = "countries/Niagara.txt"
NSC = "countries/Carolina.txt"
COV = "countries/United Virginia.txt"
XKY = "countries/Kentucky.txt"
FTK = "countries/Fort Knox.txt"
BWL = "countries/Bowling Green.txt"
PUL = "countries/Pulaski.txt"
PIK = "countries/Pike.txt"
LDN = "countries/London.txt"
LXG = "countries/Lexington.txt"
LVL = "countries/Louisville.txt"
PDC = "countries/Paducah.txt"
OWB = "countries/Owensboro.txt"
XMA = "countries/Massachusetts.txt"
BTO = "countries/Boston.txt"
DED = "countries/Dedham.txt"
TTN = "countries/Taunton.txt"
PLY = "countries/Plymouth.txt"
BRN = "countries/Barnstable.txt"
MVD = "countries/Marthas Vineyard.txt"
NTK = "countries/Nantucket.txt"
CBG = "countries/Cambridge.txt"
SWT = "countries/Mass Salem.txt"
PFD = "countries/Pittsfield.txt"
GFD = "countries/Greenfield.txt"
NHT = "countries/Northampton.txt"
HPD = "countries/Hampden.txt"
WOR = "countries/Worcester.txt"
XMD = "countries/Maryland.txt"
BLR = "countries/Baltimore.txt"
BEL = "countries/Bel Air.txt"
ELC = "countries/Ellicott.txt"
WMS = "countries/Westminster.txt"
FDK = "countries/Frederick.txt"
QAN = "countries/Queen Annes.txt"
EAS = "countries/Easton.txt"
DCR = "countries/Dorchester.txt"
SLB = "countries/Salisbury.txt"
SNH = "countries/Snow Hill.txt"
ROK = "countries/Semper.txt"
CEC = "countries/Cecil.txt"
WGM = "countries/Rockville.txt"
PGE = "countries/Prince George.txt"
ANP = "countries/Annapolis.txt"
LEO = "countries/Leonard.txt"
CHS = "countries/Charles.txt"
CVT = "countries/Calvert.txt"
XME = "countries/Maine.txt"
BAG = "countries/Bangor.txt"
TPL = "countries/Two Portlands.txt"
LWT = "countries/Lewiston.txt"
KBC = "countries/Kennebec.txt"
MTL = "countries/Mid-Atlantic.txt"
XMS = "countries/Mississippi.txt"
JSN = "countries/Jackson.txt"
MRD = "countries/Meridian.txt"
TPO = "countries/Tupelo.txt"
WPT = "countries/West Point.txt"
BLX = "countries/Biloxi.txt"
HTB = "countries/Hattiesburg.txt"
XNC = "countries/North Carolina.txt"
WKS = "countries/Wilkes.txt"
BOO = "countries/Boone.txt"
FRC = "countries/Forest City.txt"
MRN = "countries/McDowell.txt"
ASV = "countries/Asheville.txt"
CLW = "countries/Cullowhee.txt"
CLT = "countries/Charlotte.txt"
SHB = "countries/Shelby.txt"
FYV = "countries/Fayetteville.txt"
PRT = "countries/Pinehurst.txt"
LBT = "countries/Lumberton.txt"
ERH = "countries/East Rockingham.txt"
GNR = "countries/Greensboro.txt"
WSN = "countries/Winston.txt"
HKR = "countries/Hickory.txt"
ABM = "countries/Albemarle.txt"
RAL = "countries/Raleigh.txt"
DUR = "countries/Durham.txt"
HDS = "countries/Henderson.txt"
EZB = "countries/Elizabeth.txt"
KLL = "countries/Kill Devil.txt"
ROR = "countries/Roanoke Rapids.txt"
NBE = "countries/New Bern.txt"
GVK = "countries/Pitt Greenville.txt"
MHD = "countries/Morehead.txt"
OSW = "countries/Onslow.txt"
PWT = "countries/Port Wilmington.txt"
RMT = "countries/Rocky Mount.txt"
WIL = "countries/Wilson.txt"
GLD = "countries/Goldsboro.txt"
NEG = "countries/New England.txt"
XNH = "countries/New Hampshire.txt"
LCT = "countries/Upper Valley.txt"
RKH = "countries/Rockingham.txt"
STF = "countries/Strafford.txt"
LCN = "countries/Laconia.txt"
CCD = "countries/Concord.txt"
MCR = "countries/Manchester.txt"
KEE = "countries/Keene.txt"
BLN = "countries/Berlin.txt"
XNJ = "countries/New Jersey.txt"
TRN = "countries/Trenton.txt"
SMV = "countries/Somerville.txt"
MMH = "countries/Monmouth.txt"
NBK = "countries/New Brunswick.txt"
FMT = "countries/Flemington.txt"
BVD = "countries/Belvidere.txt"
NWK = "countries/Newark.txt"
JYC = "countries/Jersey City.txt"
HKS = "countries/Hackensack.txt"
PSC = "countries/Passaic.txt"
UNI = "countries/Union.txt"
MRS = "countries/Morris.txt"
NTN = "countries/Newton.txt"
VIN = "countries/Vineland.txt"
ALC = "countries/Atlantic.txt"
OCA = "countries/Oceania.txt"
BLT = "countries/Mount Holly.txt"
CDN = "countries/Jersey Camden.txt"
WBY = "countries/Woodbury.txt"
JSM = "countries/Jersey Salem.txt"
OCN = "countries/Ocean.txt"
XNY = "countries/New York.txt"
HUD = "countries/Hudson.txt"
ABY = "countries/Albany.txt"
GSF = "countries/Glens Falls.txt"
GLV = "countries/Gloversville.txt"
AMS = "countries/Amsterdam.txt"
UTI = "countries/Utica.txt"
WTR = "countries/Watertown.txt"
ODB = "countries/Ogdensburg.txt"
MLN = "countries/Malone.txt"
PTB = "countries/Plattsburgh.txt"
MHT = "countries/Manhattan.txt"
BRX = "countries/The Bronx.txt"
QNS = "countries/Queens.txt"
BKL = "countries/Brooklyn.txt"
STI = "countries/Staten Island.txt"
NAS = "countries/Nassau.txt"
SUF = "countries/Suffolk.txt"
YON = "countries/Yonkers.txt"
PUT = "countries/Putnam.txt"
ROC = "countries/Rockland.txt"
PKS = "countries/Poughkeepsie.txt"
GSN = "countries/Goshen.txt"
KGN = "countries/Kingston.txt"
NYC = "countries/New York City.txt"
SYC = "countries/Syracuse.txt"
AUB = "countries/Auburn.txt"
RCR = "countries/Rochester.txt"
SNF = "countries/Seneca Falls.txt"
BAT = "countries/Batavia.txt"
BUF = "countries/Buffalo.txt"
OLE = "countries/Olean.txt"
JMS = "countries/Jamestown.txt"
ONT = "countries/Oneonta.txt"
CLD = "countries/Cortland.txt"
ITH = "countries/Ithaca.txt"
BGH = "countries/Binghamton.txt"
ELM = "countries/Elmira.txt"
CNG = "countries/Corning.txt"
XPA = "countries/Pennsylvania.txt"
BSB = "countries/Bloomsburg.txt"
SBY = "countries/Sunbury.txt"
LSB = "countries/Lewisburg.txt"
SLG = "countries/Selinsgrove.txt"
LWS = "countries/Lewis.txt"
SCG = "countries/Nittany.txt"
DBS = "countries/Du Bois.txt"
HTD = "countries/Huntingdon.txt"
LOO = "countries/Atloona.txt"
JON = "countries/Johnsland.txt"
SMS = "countries/Somerset.txt"
RDG = "countries/Reading.txt"
LCR = "countries/Lancaster.txt"
PTV = "countries/Pottsville.txt"
HSB = "countries/Harrisburg.txt"
YRK = "countries/York.txt"
GTY = "countries/Gettysburg.txt"
LBN = "countries/Lebanon.txt"
CSB = "countries/Chambersburg.txt"
NCA = "countries/New Castle.txt"
OIL = "countries/Petrolia.txt"
EIE = "countries/Erie.txt"
MEA = "countries/Meadville.txt"
WRN = "countries/Warren.txt"
PHL = "countries/Philadelphia.txt"
CST = "countries/Chester.txt"
NRT = "countries/Norristown.txt"
BKS = "countries/Bucks.txt"
PIT = "countries/Pittsburgh.txt"
WMP = "countries/Williamsport.txt"
LKH = "countries/Lock Haven.txt"
PDA = "countries/Penndiana.txt"
BDF = "countries/Bradford.txt"
ELK = "countries/Elk.txt"
ALN = "countries/Allen.txt"
ESB = "countries/East Stroudsburg.txt"
SCR = "countries/Scranton.txt"
SAY = "countries/Sayre.txt"
XRI = "countries/Rhode Island.txt"
PVD = "countries/Providence.txt"
EGW = "countries/East Greenwich.txt"
SKT = "countries/South Kingstown.txt"
NPT = "countries/Newport.txt"
XSC = "countries/South Carolina.txt"
CLS = "countries/Charleston.txt"
HIL = "countries/Bluffton.txt"
CUM = "countries/Columbia.txt"
ONG = "countries/Orangeburg.txt"
NBR = "countries/Newberry.txt"
LGT = "countries/Low Georgetown.txt"
MYT = "countries/Myrtle.txt"
SMT = "countries/Sumter.txt"
FLT = "countries/Florence.txt"
BNV = "countries/Bennettsville.txt"
GWD = "countries/Greenwood.txt"
SNC = "countries/Seneca.txt"
GRN = "countries/Greenville.txt"
STB = "countries/Spartanburg.txt"
GFY = "countries/Gaffney.txt"
GRU = "countries/Gearup.txt"
XTN = "countries/Tennessee.txt"
CTN = "countries/Chattanooga.txt"
KNX = "countries/Knox.txt"
BDY = "countries/Bradley.txt"
NSH = "countries/Nashville.txt"
CKE = "countries/Cookeville.txt"
THM = "countries/Tullahoma.txt"
KGP = "countries/Kingsport.txt"
JSC = "countries/Johnson City.txt"
MST = "countries/Morristown.txt"
CKV = "countries/Clarkesville.txt"
JBV = "countries/Westessee.txt"
MPS = "countries/Memphis.txt"
XVA = "countries/Virginia.txt"
BSE = "countries/Big Stone Gap.txt"
CTV = "countries/Charlottesville.txt"
LYN = "countries/Lynchburg.txt"
MTV = "countries/Martinsville.txt"
DNV = "countries/Danville.txt"
RCH = "countries/Richmond.txt"
VAB = "countries/Hampton.txt"
NNK = "countries/Northern Neck.txt"
HRS = "countries/Harrisonburg.txt"
STN = "countries/Staunton.txt"
BRY = "countries/Berryville.txt"
FRR = "countries/Front Royal.txt"
WIN = "countries/Winchester.txt"
RIP = "countries/Rapidan.txt"
ARG = "countries/Arlington.txt"
FFX = "countries/Fairfax.txt"
LEE = "countries/Leesburg.txt"
VMA = "countries/Manassas.txt"
SFD = "countries/Stafford.txt"
SPV = "countries/Spotsylvania.txt"
CUL = "countries/Culpeper.txt"
RAP = "countries/Rappahannock.txt"
WRT = "countries/Warrenton.txt"
ROA = "countries/Roanoke.txt"
BLK = "countries/Blacksburg.txt"
XVT = "countries/Vermont.txt"
VTB = "countries/Barre.txt"
BTV = "countries/Burlington.txt"
RUT = "countries/Rutland.txt"
BNT = "countries/Bennington.txt"
XWV = "countries/West Virginia.txt"
MGT = "countries/Morgantown.txt"
CBL = "countries/Cumberland.txt"
GRT = "countries/Garrett.txt"
HGT = "countries/Martinsburg.txt"
EKS = "countries/Elkins.txt"
BLU = "countries/Bluefield.txt"
BKY = "countries/Beckley.txt"
HTT = "countries/Huntington.txt"
CHW = "countries/Kanawha.txt"
PKB = "countries/Parkersburg.txt"
WHG = "countries/Wheeling.txt"
ADR = "countries/Adrian.txt"
DTW = "countries/Detroit.txt"
FNT = "countries/Flint.txt"
MNO = "countries/Erie Monroe.txt"
WVR = "countries/Ann Arbor.txt"
GRR = "countries/Grand Rapids.txt"
MRT = "countries/Marinette.txt"
BAY = "countries/Bay.txt"
BGR = "countries/Big Rapids.txt"
GTT = "countries/Gratiot.txt"
HRN = "countries/Huron.txt"
LSG = "countries/Lansing.txt"
LDT = "countries/Ludington.txt"
MDL = "countries/Midland.txt"
MTP = "countries/Mt Pleasant.txt"
MKG = "countries/Muskegon.txt"
MBS = "countries/Saginaw.txt"
SBD = "countries/South Bend.txt"
APN = "countries/Alpena.txt"
CDC = "countries/Cadillac.txt"
TVC = "countries/Grand Traverse.txt"
PLN = "countries/Mackinaw.txt"
BTK = "countries/Battle Creek.txt"
HLD = "countries/Holland.txt"
JKS = "countries/Rose Jackson.txt"
AZO = "countries/Kalamazoo.txt"
NIL = "countries/Niles.txt"
ESC = "countries/Escanaba.txt"
GGB = "countries/Gogebic.txt"
CMX = "countries/Houghton.txt"
IMT = "countries/Iron Mountain.txt"
MQT = "countries/Marquette.txt"
CIU = "countries/Sault.txt"
IOS = "countries/Iosco.txt"
LBL = "countries/Liberal.txt"
GCK = "countries/Gardenia.txt"
DDC = "countries/Dodge.txt"
HYS = "countries/Hays.txt"
HCH = "countries/Hutchinson.txt"
MCP = "countries/McPherson.txt"
WTA = "countries/Wichita.txt"
WFD = "countries/Winfield.txt"
EPR = "countries/Emporia.txt"
MHK = "countries/Little Apple.txt"
TPK = "countries/Topeka.txt"
LWC = "countries/Lawrence.txt"
CFE = "countries/Coffeeland.txt"
PBG = "countries/Pittsburg.txt"
KSC = "countries/Kansas City.txt"
STJ = "countries/St Joseph.txt"
SLI = "countries/Salina.txt"
YGL = "countries/Youngstown.txt"
ATB = "countries/Ashtabula.txt"
SLM = "countries/Penn Salem.txt"
JFF = "countries/Jefferson.txt"
WDC = "countries/DC.txt"
CIN = "countries/Cincinnati.txt"
EVN = "countries/Evansville.txt"
TLD = "countries/Toledo.txt"
CLV = "countries/Cleveland.txt"
AKR = "countries/Akron.txt"
CNT = "countries/Canton.txt"
CBS = "countries/Columbus.txt"
DAY = "countries/Dayton.txt"
LIM = "countries/Lima.txt"
MFD = "countries/Mansfield.txt"
OSF = "countries/Ohio Springfield.txt"
SDK = "countries/Sandusky.txt"
ZNV = "countries/Zanesville.txt"
FDY = "countries/Findlay.txt"
WOO = "countries/Wooster.txt"
MAV = "countries/Marion.txt"
CVI = "countries/Clevelandianola.txt"
IDP = "countries/Indianapolis.txt"
LFY = "countries/Two Lafayettes.txt"
CCG = "countries/Chicagoland.txt"
FTW = "countries/Fort Wayne.txt"
BMT = "countries/Bloomington.txt"
MCI = "countries/Muncie.txt"
KKM = "countries/Kokomo.txt"
EKT = "countries/Elkhart.txt"
THT = "countries/Terre Haute.txt"
MIC = "countries/Michigan City.txt"
DVP = "countries/Davenport.txt"
RKF = "countries/Rockford.txt"
PEA = "countries/Peoria.txt"
BTP = "countries/Wesley.txt"
SPF = "countries/Springfield.txt"
STL = "countries/Saint Louis.txt"
CBD = "countries/Carbondale.txt"
CPN = "countries/Champaign.txt"
VML = "countries/Vermilion.txt"
DCT = "countries/Decatur.txt"
KKE = "countries/Kankakee.txt"
OTW = "countries/Ottawa.txt"
DXN = "countries/Dixon.txt"
CLE = "countries/Coles.txt"
EFH = "countries/Effingham.txt"
CTL = "countries/Centralia.txt"
QCY = "countries/Quincy.txt"
BTM = "countries/Shoquoquon.txt"
GBG = "countries/Galesburg.txt"
MCB = "countries/Macomb.txt"
MVN = "countries/Mount Vernon.txt"
GBY = "countries/Green Bay.txt"
WAU = "countries/Wausau.txt"
EAU = "countries/Eau Claire.txt"
MDS = "countries/Madison.txt"
MWK = "countries/Milwaukee.txt"
APT = "countries/Appleton.txt"
LCS = "countries/La Crosse.txt"
FDL = "countries/Fond du Lac.txt"
SHE = "countries/Sheboygan.txt"
DTH = "countries/Duluth.txt"
MNP = "countries/Minneapolis.txt"
STP = "countries/St Paul.txt"
RCA = "countries/Mayovia.txt"
STC = "countries/St Cloud.txt"
FRG = "countries/Fargo.txt"
GDF = "countries/Grand Forks.txt"
MKT = "countries/Mankato.txt"
BAI = "countries/Brainerd.txt"
FBT = "countries/Fairbault.txt"
FGF = "countries/Fergus Falls.txt"
AAA = "countries/Alexandria.txt"
BMK = "countries/Bismarck.txt"
RSM = "countries/Rushmore.txt"
SXF = "countries/Sioux Falls.txt"
PRE = "countries/Pierre.txt"
CDR = "countries/Cedar Rapids.txt"
IAC = "countries/Iowa City.txt"
DMN = "countries/Des Moines.txt"
WTL = "countries/Waterloo.txt"
OMH = "countries/Omaha.txt"
SXC = "countries/Sioux City.txt"
LNC = "countries/Lincoln.txt"
GDI = "countries/Grand Island.txt"
NPE = "countries/North Platte.txt"
SCB = "countries/Scotts Bluff.txt"
MSF = "countries/Ozark Springfield.txt"
JFC = "countries/Jefferson City.txt"
CMY = "countries/Boonslick.txt"
JPN = "countries/Joplin.txt"
CGD = "countries/Cape Girardeau.txt"
BSN = "countries/Branson.txt"
WRB = "countries/Warrensburg.txt"
LRK = "countries/Little Rock.txt"
FYT = "countries/Fayette.txt"
FTS = "countries/Fort Smith.txt"
JBR = "countries/Jonesboro.txt"
TAL = "countries/Texarkana.txt"
HOT = "countries/Hot Springs.txt"
TSA = "countries/Tulsa.txt"
OKC = "countries/Oklahoma City.txt"
LAW = "countries/Lawton.txt"
END = "countries/Enid.txt"
GMN = "countries/Guymon.txt"
AMR = "countries/Ardmore.txt"
MUS = "countries/Muskogee.txt"
NWO = "countries/New Orleans.txt"
BTR = "countries/Baton Rouge.txt"
MRR = "countries/Monroe.txt"
SVP = "countries/Shreveport.txt"
LCH = "countries/Lake Charles.txt"
RPD = "countries/Rapides.txt"
HOU = "countries/Houma.txt"
LFT = "countries/Lafayette.txt"
BIL = "countries/Billings.txt"
GFL = "countries/Great Falls.txt"
MSL = "countries/Missoula.txt"
BZM = "countries/Bozeman.txt"
IDF = "countries/Idaho Falls.txt"
BOI = "countries/Boise.txt"
SPK = "countries/Spokane.txt"
PLM = "countries/Pullman.txt"
TWF = "countries/Twin Falls.txt"
PCT = "countries/Pocatello.txt"
CHN = "countries/Cheyenne.txt"
CPR = "countries/Casper.txt"
AML = "countries/Amarillo.txt"
LBK = "countries/Lubbock.txt"
MID = "countries/Midland-Odessa.txt"
ELP = "countries/El Paso.txt"
SAG = "countries/San Angelo.txt"
ABL = "countries/Abilene.txt"
SAN = "countries/San Antonio.txt"
VIC = "countries/Victoria.txt"
LRD = "countries/Laredo.txt"
HDG = "countries/Hidalgo.txt"
BWV = "countries/Brownsville.txt"
CPC = "countries/Corpus Christi.txt"
ASN = "countries/Austin.txt"
TXK = "countries/Killeen.txt"
WAC = "countries/Waco.txt"
CES = "countries/College Station.txt"
HTN = "countries/Houston.txt"
BMN = "countries/Beaumont.txt"
DLS = "countries/Dallas.txt"
FWH = "countries/Fort Worth.txt"
TYL = "countries/Tyler.txt"
LVW = "countries/Longview.txt"
WTF = "countries/Wichita Falls.txt"
SMN = "countries/Sherman.txt"
BHM = "countries/Brenham.txt"
KRR = "countries/Kerr.txt"
WLK = "countries/Walker.txt"
CSN = "countries/Corsicana.txt"
GNB = "countries/Granbury.txt"
MNL = "countries/Mineral Wells.txt"
COK = "countries/Cooke.txt"
TXB = "countries/Bonham.txt"
PRS = "countries/Paris.txt"
PSL = "countries/Pearsall.txt"
ALI = "countries/Alice.txt"
KGV = "countries/Kingsville.txt"
LTK = "countries/Lufkin.txt"
DEL = "countries/Del Rio.txt"
PEC = "countries/Pecos.txt"
BSP = "countries/Big Spring.txt"
MCE = "countries/McAlester.txt"
ABQ = "countries/Albuquerque.txt"
SFE = "countries/Santa Fe.txt"
FMG = "countries/Navajo.txt"
CVS = "countries/Clovis.txt"
LCU = "countries/Las Cruces.txt"
DVR = "countries/Denver.txt"
BDR = "countries/Boulder.txt"
GLY = "countries/Greeley.txt"
FTC = "countries/Fort Collins.txt"
PUB = "countries/Pueblo.txt"
COS = "countries/Colorado Springs.txt"
GJT = "countries/Grand Junction.txt"
STS = "countries/Steamboat Springs.txt"
EWD = "countries/Edwards.txt"
CYC = "countries/Canyon City.txt"
PNX = "countries/Phoenix.txt"
PNL = "countries/Pinal.txt"
TSN = "countries/Tucson.txt"
NGL = "countries/Nogales.txt"
PSN = "countries/Payson.txt"
FLG = "countries/Flagstaff.txt"
PST = "countries/Prescott.txt"
YUM = "countries/Yuma.txt"
SVS = "countries/Sierra Vista.txt"
LHV = "countries/Lake Havasu.txt"
OGN = "countries/Ogden.txt"
SLC = "countries/Salt Lake.txt"
PRV = "countries/Provo.txt"
LGN = "countries/Logan.txt"
HBR = "countries/Heber.txt"
SGG = "countries/St George.txt"
LVG = "countries/Las Vegas.txt"
REN = "countries/Reno.txt"
CRS = "countries/Carson City.txt"
PHR = "countries/Pahrump.txt"
FLN = "countries/Fallon.txt"
ECT = "countries/El Centro.txt"
SDG = "countries/San Diego.txt"
RVS = "countries/Riverside.txt"
SBN = "countries/San Bernardino.txt"
ORA = "countries/Orange.txt"
LAX = "countries/Los Angeles.txt"
VTR = "countries/Ventura.txt"
SBB = "countries/Santa Barbara.txt"
SLU = "countries/San Luis Obispo.txt"
BKF = "countries/Bakersfield.txt"
VSL = "countries/Visalia.txt"
HFR = "countries/Hanford.txt"
SLA = "countries/Salinas.txt"
FSN = "countries/Fresno.txt"
MDR = "countries/Madera.txt"
SJS = "countries/San Jose.txt"
SAC = "countries/Santa Cruz.txt"
FFC = "countries/San Francisco.txt"
MCD = "countries/Merced.txt"
MDO = "countries/Modesto.txt"
STO = "countries/Stockton.txt"
ALM = "countries/Alameda.txt"
CTC = "countries/Contra Costa.txt"
RIN = "countries/Marin.txt"
SRA = "countries/Santa Rosa.txt"
NPA = "countries/Napa.txt"
VLJ = "countries/Vallejo.txt"
SCM = "countries/Sacramento.txt"
TKE = "countries/Truckee.txt"
YUB = "countries/Yuba.txt"
SNR = "countries/Sonora.txt"
CLK = "countries/Clearlake.txt"
UKL = "countries/Ukiah.txt"
ERK = "countries/Eureka.txt"
CCC = "countries/Crescent City.txt"
RED = "countries/Redding.txt"
RBF = "countries/Red Bluff.txt"
SSV = "countries/Susanville.txt"
CCO = "countries/Chico.txt"
SRR = "countries/Sierra.txt"
SSU = "countries/Siskiyou.txt"
TNY = "countries/Trinity.txt"
OSM = "countries/Salem.txt"
PLD = "countries/Portland.txt"
LIN = "countries/Linn.txt"
CRV = "countries/Coravallis.txt"
EUG = "countries/Eugene.txt"
ORB = "countries/Bend.txt"
MDF = "countries/Medford.txt"
GPS = "countries/Grants Pass.txt"
KNW = "countries/Kennewick.txt"
WAW = "countries/Walla Walla.txt"
SEA = "countries/Seattle.txt"
SKG = "countries/Skagit.txt"
BLH = "countries/Bellingham.txt"
YKM = "countries/Yakima.txt"
OLY = "countries/Olympia.txt"
BRM = "countries/Bremerton.txt"
WTC = "countries/Wenatchee.txt"
MSS = "countries/Moses Lake.txt"
CLZ = "countries/Cowlitz.txt"
ANC = "countries/Anchorage.txt"
FBK = "countries/Fairbanks.txt"
JUN = "countries/Juneau.txt"
MOK = "countries/Moku o Keawe.txt"
AUI = "countries/Maui.txt"
OAU = "countries/Oahu.txt"
UAI = "countries/Kauai.txt"
PA2 = "countries/Papal States.txt"
XOH = "countries/Ohio.txt"
XLA = "countries/Louisiana.txt"
XIN = "countries/Indiana.txt"
XIL = "countries/Illinois.txt"
XMO = "countries/Missouri.txt"
XAR = "countries/Arkansas.txt"
XMI = "countries/Michigan.txt"
XTX = "countries/Texas.txt"
XIA = "countries/Iowa.txt"
XWI = "countries/Wisconsin.txt"
XCA = "countries/California.txt"
XMN = "countries/Minnesota.txt"
XOR = "countries/Oregon.txt"
XKS = "countries/Kansas.txt"
XNV = "countries/Nevada.txt"
XNE = "countries/Nebraska.txt"
XCO = "countries/Colorado.txt"
XND = "countries/North Dakota.txt"
XSD = "countries/South Dakota.txt"
XMT = "countries/Montana.txt"
XWA = "countries/Washington.txt"
XID = "countries/Idaho.txt"
XWY = "countries/Wyoming.txt"
XUT = "countries/Utah.txt"
XOK = "countries/Oklahoma.txt"
XNM = "countries/New Mexico.txt"
XAZ = "countries/Arizona.txt"
XAK = "countries/Alaska.txt"
XHI = "countries/Hawaii.txt"
BUT = "countries/Butte.txt"
MNT = "countries/Minot.txt"
NCZ = "countries/Natchez.txt"
PPB = "countries/Poplar Bluff.txt"
MHM = "countries/Mountain Home.txt"
FLW = "countries/St Robert.txt"
KKV = "countries/Kirksville.txt"
NFK = "countries/Norfolk.txt"
CRL = "countries/Carroll.txt"
SML = "countries/Storm Lake.txt"
SPT = "countries/Spirit Lake.txt"
MCL = "countries/Mitchell.txt"
BNS = "countries/Brookings.txt"
CGT = "countries/Codington.txt"
MHL = "countries/Marshall.txt"
BWN = "countries/Brownwood.txt"
DRG = "countries/Durango.txt"
GTL = "countries/Great Lakes.txt"
GTP = "countries/Great Plains.txt"
FTR = "countries/Frontier.txt"
CCI = "countries/Cascadia.txt"
GSW = "countries/Greater Southwest.txt"
DPS = "countries/Deep South.txt"
PAC = "countries/Pacifica.txt"
DIX = "countries/Dixieland.txt"
HLE = "countries/Heartland Empire.txt"
WDO = "countries/Western Dominion.txt"
XUS = "countries/United States of America.txt"
APL = "countries/Appalachia.txt"
DST = "countries/Deseret.txt"
PBF = "countries/Pine Bluff.txt"
